12
###@########
#       #  #
### ##     #
#   #      #
#   #      #
#       ####
##   #     #
#   ########
#   #$     #
# #     #  #
#     ###  # 
############