14
#  ###   #    
#          @  
######    ####
#   #     #   
#    #       #
        ##    
########      
$  #    ###   
 #    #  ## ##
#         #   
#      ###### 
#  #      #   
     ###     #
####    ### # 